1111111111
1210000103
1000101001
1110111101
1010001001
1000101011
1010101001
1010101101
1000100001
1111111111