1111111111
1200011003
1101000101
1000010101
1010010101
1000100101
1110001101
1000111101
1010000001
1111111111