1111111111
1000102131
1010101101
1010000101
1010111101
1011100001
1000001101
1010100101
1001001001
1111111111