1111111111
1000102131
1010101101
1010101001
1010001101
1011110001
1000001101
1010100001
1000001001
1111111111
